1111111111111
100100000C001
1C0C011111001
1P0011E1000C1
1111111111111