11111111
1P0000P1
10111101
100C1E01
11111111