11111111
1P000001
10111101
100C1E01
11111111